%%%%%
%.P %
%%% %
%G  %
%%%%%
